xxxxxxxxxxxx
xxx----xx-xx
x-x--x-----x
x---xx-----x
x---x------x
x---xxx--xxx
x-x--x---xxx
x----x---xxx
x--0-x----Sx
xxxxxxxxxxxx
